        |.'',                                      ,''.|
        |.'.'',                                  ,''.'.|
        |.'.'.'',                              ,''.'.'.|
        |.'.'.'.'',                          ,''.'.'.'.|
        |.'.'.'.'.'.'.                       |.'.'.'.'.|
        |.'.'.'.'.'.'.'.                 ;===|.'.'.'.'.|
        |.'.'.'.'.'.'.'.',             ,'|:::|.'.'.'.'.|
        |.'.'.'.'..'.'.'.|,,________,'|.'|---|.'.'.'.'.|
        |.'.'.'.'.'.'.''.|'|????????|'|.'|:::|.'.'.'.'.|
        |,',',',','.'.'.,|'|????????|'|,'|---|,',',',',|
        |.'.'.'.'.'.'.''.|'|????????|'|.'|:::|.'.'.'.'.|
        |.'.'.'.'.'.'.','    /%%%\    ','|---|.'.'.'.'.|
        |.'.'.'.'.'.','     /%%%%%\     ':===|.'.'.'.'.|
        |.'.'.'.'.','      /%%%%%%%%%%%%%%%%%|.'.'.'.'.|
        |.'.'.'.','       /%%%%%%%%%\        ','.'.'.'.|
        |.'.'.','        /%%%%%%%%%%%\         ','.'.'.|
        |.'.','         /%%%%%%%%%%%%%\          ','.'.|
        |.','          /%%%%%%%%%%%%%%%\           ','.|
        |;            /%%%%%%%%%%%%%%%%%\             ;|