               |'.',                                          ,'.'|
               |.'.'',                                      ,''.'.|
               |.'.'.'',                                  ,''.'.'.|
               |.'.'.'.'',                              ,''.'.'.'.|
               |.'.'.'.'.|                              |.'.'.'.'.|
               |.'.'.'.'.|===;                      ;===|.'.'.'.'.|
               |.'.'.'.'.|:::|',                  ,'|:::|.'.'.'.'.|
               |.'.'.'.'.|---|'.'|_____________,,|.'|---|.'.'.'.'.|
               |.'.'.'.'.|:::|'.'|?????????????|'|.'|:::|.'.'.'.'.|
               |,',',',',|---|','|?????????????|'|,'|---|,',',',',|
               |.'.'.'.'.|:::|'.'|?????????????|'|.'|:::|.'.'.'.'.|
               |.'.'.'.'.|---|','      /%%%\     ','|---|.'.'.'.'.|
               |.'.'.'.'.|===:'       /%%%%%\      ':===|.'.'.'.'.|
               |.'.'.'.'.|%%%%%%%%%%%%%%%%%%%%%%%%%%%%%%|.'.'.'.'.|
               |.'.'.'.','          /%%%%%%%%%\         ','.'.'.'.|
               |.'.'.','           /%%%%%%%%%%%\          ','.'.'.|
               |.'.','            /%%%%%%%%%%%%%\           ','.'.|
               |.','             /%%%%%%%%%%%%%%%\            ','.|
               |;_______________/%%%%%%%%%%%%%%%%%\______________;|