            |.'',          [__________________]       ,''.|
            |.'.'',            \==========/         ,''.'.|
            |.'.'.'',       [----------------]    ,''.'.'.|
            |.'.'.'.'',,,,,,,,,,,,,,,,,,,,,,,,,,,''.'.'.'.|
            |.'.'.'.'.|                         |.'.'.'.'.|
            |.'.'.'.'.|                         |.'.'.'.'.|
            |.'.'.'.'.|       +---------+       |.'.'.'.'.|
            |.'.'.'.'.|       |         |       |.'.'.'.'.|
            |.'.'.'.'.|       |         |       |.'.'.'.'.|
            |,',',',',|       |         |       |,',',',',|
            |.'.'.'.'.|       |       o |       |.'.'.'.'.|
            |.'.'.'.'.|       |         |       |.'.'.'.'.|
            |.'.'.'.'.|       | [=====] |       |.'.'.'.'.|
            |.'.'.'.'.|       |         |       |.'.'.'.'.|
            |.'.', .'.''''''''''''''''''''''''''','.'.'.'.|
            |.'.'.'.........    [##]       . ..|| ','.'.'.|
            |.+----------','              '.[__||   ','.'.|
            |.+---------+' /%%%%%%%%%%%%%%%\          ','.|
            |;            /%%%%%%%%%%%%%%%%%\            ;|